************
*S  *     E*
*   *     **
*   ****   *
*          *
*          *
************
